Country,Month,days_inMonth,total_confirmed,total_deaths,total_recoverd
Afghanistan,2020-01,31,0,0,0
Afghanistan,2020-02,29,7,0,7
Afghanistan,2020-03,31,1392,33,1359
Afghanistan,2020-04,30,29234,920,28314
Afghanistan,2020-05,31,238689,5187,233502
Afghanistan,2020-06,30,767196,15396,751800
Afghanistan,2020-07,31,1082603,33918,1048685
Afghanistan,2020-08,31,1164540,42156,1122384
Afghanistan,2020-09,30,1164954,42995,1121959
Afghanistan,2020-10,31,1248078,46303,1201775
Afghanistan,2020-11,6,251136,9295,241841
Albania,2020-01,10,0,0,0
Albania,2020-02,29,0,0,0
Albania,2020-03,31,2475,106,2369
Albania,2020-04,30,16162,744,15418
Albania,2020-05,31,29237,977,28260
Albania,2020-06,30,52278,1250,51028
Albania,2020-07,31,122401,3397,119004
Albania,2020-08,31,234515,7072,227443
Albania,2020-09,30,354284,10389,343895
Albania,2020-10,31,530310,13853,516457
Albania,2020-11,6,135195,3245,131950
Algeria,2020-01,31,0,0,0
Algeria,2020-02,29,6,0,6
Algeria,2020-03,31,5538,368,5170
Algeria,2020-04,30,72787,9603,63184
Algeria,2020-05,31,216782,17104,199678
Algeria,2020-06,30,342332,23859,318473
Algeria,2020-07,31,690773,33018,657755
Algeria,2020-08,31,1199176,42728,1156448
Algeria,2020-09,30,1465326,49190,1416136
Algeria,2020-10,31,1690043,57420,1632623
Algeria,2020-11,6,359179,12027,347152
Andorra,2020-01,10,0,0,0
Andorra,2020-02,29,0,0,0
Andorra,2020-03,31,3163,51,3112
Andorra,2020-04,30,19475,947,18528
Andorra,2020-05,31,23517,1527,21990
Andorra,2020-06,30,25602,1546,24056
Andorra,2020-07,31,27244,1612,25632
Andorra,2020-08,31,31633,1633,30000
Andorra,2020-09,30,46149,1590,44559
Andorra,2020-10,31,105773,1917,103856
Andorra,2020-11,6,30317,450,29867
Angola,2020-03,12,54,8,46
Angola,2020-04,30,621,60,561
Angola,2020-05,31,1698,87,1611
Angola,2020-06,30,4858,219,4639
Angola,2020-07,31,20913,954,19959
Angola,2020-08,31,60666,2683,57983
Angola,2020-09,30,113787,4343,109444
Angola,2020-10,31,239182,7426,231756
Angola,2020-11,6,71396,1777,69619
Antigua and Barbuda,2020-01,10,0,0,0
Antigua and Barbuda,2020-02,29,0,0,0
Antigua and Barbuda,2020-03,31,68,0,68
Antigua and Barbuda,2020-04,30,634,65,569
Antigua and Barbuda,2020-05,31,778,93,685
Antigua and Barbuda,2020-06,30,1069,90,979
Antigua and Barbuda,2020-07,31,2388,93,2295
Antigua and Barbuda,2020-08,31,2884,93,2791
Antigua and Barbuda,2020-09,30,2893,90,2803
Antigua and Barbuda,2020-10,31,3613,93,3520
Antigua and Barbuda,2020-11,6,776,18,758
Argentina,2020-01,10,0,0,0
Argentina,2020-02,29,0,0,0
Argentina,2020-03,31,7583,185,7398
Argentina,2020-04,30,80950,3673,77277
Argentina,2020-05,31,287979,11883,276096
Argentina,2020-06,30,1138931,27543,1111388
Argentina,2020-07,31,3855543,71459,3784084
Argentina,2020-08,31,9470596,189091,9281505
Argentina,2020-09,30,17879248,380006,17499242
Argentina,2020-10,31,30338432,809265,29529167
Argentina,2020-11,6,7265600,195371,7070229
Armenia,2020-01,31,0,0,0
Armenia,2020-02,29,0,0,0
Armenia,2020-03,31,4631,15,4616
Armenia,2020-04,30,38045,556,37489
Armenia,2020-05,31,158661,2111,156550
Armenia,2020-06,30,537227,9057,528170
Armenia,2020-07,31,1039471,18996,1020475
Armenia,2020-08,31,1291320,25535,1265785
Armenia,2020-09,30,1404937,27717,1377220
Armenia,2020-10,31,2051869,34126,2017743
Armenia,2020-11,6,590924,8762,582162
Australia,2020-01,31,47,0,47
Australia,2020-02,29,502,0,502
Australia,2020-03,31,40213,208,40005
Australia,2020-04,30,190413,1892,188521
Australia,2020-05,31,218061,3081,214980
Australia,2020-06,30,223329,3076,220253
Australia,2020-07,31,371080,4093,366987
Australia,2020-08,31,719630,13462,706168
Australia,2020-09,30,802176,24706,777470
Australia,2020-10,31,848863,27968,820895
Australia,2020-11,6,165816,5442,160374
Austria,2020-01,31,0,0,0
Austria,2020-02,29,28,0,28
Austria,2020-03,31,94973,754,94219
Austria,2020-04,30,422514,12119,410395
Austria,2020-05,31,501758,19558,482200
Austria,2020-06,30,516627,20532,496095
Austria,2020-07,31,603828,22010,581818
Austria,2020-08,31,742279,22538,719741
Austria,2020-09,30,1076238,22890,1053348
Austria,2020-10,31,2099348,28372,2070976
Austria,2020-11,6,772742,7547,765195
Azerbaijan,2020-01,31,0,0,0
Azerbaijan,2020-02,29,0,0,0
Azerbaijan,2020-03,31,2213,42,2171
Azerbaijan,2020-04,30,36859,448,36411
Azerbaijan,2020-05,31,105250,1266,103984
Azerbaijan,2020-06,30,338579,4089,334490
Azerbaijan,2020-07,31,809198,10642,798556
Azerbaijan,2020-08,31,1069923,15648,1054275
Azerbaijan,2020-09,30,1160133,17029,1143104
Azerbaijan,2020-10,31,1418773,19836,1398937
Azerbaijan,2020-11,6,361555,4727,356828
Bahamas,2020-03,12,104,0,104
Bahamas,2020-04,30,1645,246,1399
Bahamas,2020-05,31,2954,341,2613
Bahamas,2020-06,30,3102,330,2772
Bahamas,2020-07,31,6873,350,6523
Bahamas,2020-08,31,43423,828,42595
Bahamas,2020-09,30,95010,2151,92859
Bahamas,2020-10,31,172930,3660,169270
Bahamas,2020-11,6,41014,895,40119
"Bahamas, The",2020-01,10,0,0,0
"Bahamas, The",2020-02,29,0,0,0
"Bahamas, The",2020-03,19,9,0,9
Bahrain,2020-01,31,0,0,0
Bahrain,2020-02,29,208,0,208
Bahrain,2020-03,31,8285,45,8240
Bahrain,2020-04,30,51149,194,50955
Bahrain,2020-05,31,218860,360,218500
Bahrain,2020-06,30,590720,1509,589211
Bahrain,2020-07,31,1088929,3732,1085197
Bahrain,2020-08,31,1458583,5354,1453229
Bahrain,2020-09,30,1875123,6557,1868566
Bahrain,2020-10,31,2399602,9055,2390547
Bahrain,2020-11,6,496230,1957,494273
Bangladesh,2020-01,10,0,0,0
Bangladesh,2020-02,29,0,0,0
Bangladesh,2020-03,31,597,54,543
Bangladesh,2020-04,30,77899,2316,75583
Bangladesh,2020-05,31,770797,11228,759569
Bangladesh,2020-06,30,2934986,38391,2896595
Bangladesh,2020-07,31,6142040,78984,6063056
Bangladesh,2020-08,31,8641280,115271,8526009
Bangladesh,2020-09,30,10283274,144880,10138394
Bangladesh,2020-10,31,12009235,174790,11834445
Bangladesh,2020-11,6,2490323,36064,2454259
Barbados,2020-01,10,0,0,0
Barbados,2020-02,29,0,0,0
Barbados,2020-03,31,289,0,289
Barbados,2020-04,30,2118,129,1989
Barbados,2020-05,31,2708,217,2491
Barbados,2020-06,30,2865,210,2655
Barbados,2020-07,31,3222,217,3005
Barbados,2020-08,31,4718,217,4501
Barbados,2020-09,30,5531,210,5321
Barbados,2020-10,31,6739,217,6522
Barbados,2020-11,6,1438,42,1396
Belarus,2020-01,31,0,0,0
Belarus,2020-02,29,3,0,3
Belarus,2020-03,31,1616,2,1614
Belarus,2020-04,30,164429,1259,163170
Belarus,2020-05,31,917421,5132,912289
Belarus,2020-06,30,1646440,9640,1636800
Belarus,2020-07,31,2035015,15120,2019895
Belarus,2020-08,31,2163721,19202,2144519
Belarus,2020-09,30,2253093,22948,2230145
Belarus,2020-10,31,2721834,28527,2693307
Belarus,2020-11,6,616886,5981,610905
Belgium,2020-01,31,0,0,0
Belgium,2020-02,29,27,0,27
Belgium,2020-03,31,101783,3850,97933
Belgium,2020-04,30,1029357,139553,889804
Belgium,2020-05,31,1698239,275868,1422371
Belgium,2020-06,30,1804752,289823,1514929
Belgium,2020-07,31,1986463,303776,1682687
Belgium,2020-08,31,2426264,307286,2118978
Belgium,2020-09,30,2989031,298264,2690767
Belgium,2020-10,31,7371607,326678,7044929
Belgium,2020-11,6,2835327,74363,2760964
Belize,2020-03,12,21,0,21
Belize,2020-04,30,426,48,378
Belize,2020-05,31,558,62,496
Belize,2020-06,30,639,60,579
Belize,2020-07,31,1232,62,1170
Belize,2020-08,31,14820,174,14646
Belize,2020-09,30,46417,592,45825
Belize,2020-10,31,85824,1318,84506
Belize,2020-11,6,23418,384,23034
Benin,2020-01,10,0,0,0
Benin,2020-02,29,0,0,0
Benin,2020-03,31,77,0,77
Benin,2020-04,30,1233,26,1207
Benin,2020-05,31,6734,75,6659
Benin,2020-06,30,18724,282,18442
Benin,2020-07,31,46628,891,45737
Benin,2020-08,31,63195,1199,61996
Benin,2020-09,30,68225,1202,67023
Benin,2020-10,31,77230,1271,75959
Benin,2020-11,6,16386,254,16132
Bhutan,2020-01,10,0,0,0
Bhutan,2020-02,29,0,0,0
Bhutan,2020-03,31,50,0,50
Bhutan,2020-04,30,170,0,170
Bhutan,2020-05,31,597,0,597
Bhutan,2020-06,30,1931,0,1931
Bhutan,2020-07,31,2724,0,2724
Bhutan,2020-08,31,4520,0,4520
Bhutan,2020-09,30,7542,0,7542
Bhutan,2020-10,31,9986,0,9986
Bhutan,2020-11,6,2151,0,2151
Bolivia,2020-01,10,0,0,0
Bolivia,2020-02,29,0,0,0
Bolivia,2020-03,31,789,17,772
Bolivia,2020-04,30,15861,943,14918
Bolivia,2020-05,31,146486,5733,140753
Bolivia,2020-06,30,637995,20914,617081
Bolivia,2020-07,31,1743893,64801,1679092
Bolivia,2020-08,31,3125471,128286,2997185
Bolivia,2020-09,30,3840016,215758,3624258
Bolivia,2020-10,31,4323564,261610,4061954
Bolivia,2020-11,6,852828,52586,800242
Bosnia and Herzegovina,2020-01,10,0,0,0
Bosnia and Herzegovina,2020-02,29,0,0,0
Bosnia and Herzegovina,2020-03,31,3246,63,3183
Bosnia and Herzegovina,2020-04,30,34745,1328,33417
Bosnia and Herzegovina,2020-05,31,69569,3832,65737
Bosnia and Herzegovina,2020-06,30,97110,5039,92071
Bosnia and Herzegovina,2020-07,31,249053,7730,241323
Bosnia and Herzegovina,2020-08,31,503074,15080,487994
Bosnia and Herzegovina,2020-09,30,728615,22139,706476
Bosnia and Herzegovina,2020-10,31,1104925,31351,1073574
Bosnia and Herzegovina,2020-11,6,339464,8285,331179
Botswana,2020-03,12,11,2,9
Botswana,2020-04,30,456,30,426
Botswana,2020-05,31,855,31,824
Botswana,2020-06,30,2403,30,2373
Botswana,2020-07,31,15536,37,15499
Botswana,2020-08,31,37913,91,37822
Botswana,2020-09,30,74661,355,74306
Botswana,2020-10,31,148029,618,147411
Botswana,2020-11,6,43431,153,43278
Brazil,2020-01,31,0,0,0
Brazil,2020-02,29,7,0,7
Brazil,2020-03,31,42842,1177,41665
Brazil,2020-04,30,1129976,72376,1057600
Brazil,2020-05,31,8371947,532338,7839609
Brunei,2020-01,10,0,0,0
Brunei,2020-02,29,0,0,0
Brunei,2020-03,31,1817,5,1812
Brunei,2020-04,30,4098,30,4068
Brunei,2020-05,31,4357,37,4320
Brunei,2020-06,30,4230,76,4154
Brunei,2020-07,31,4371,93,4278
Brunei,2020-08,31,4419,93,4326
Brunei,2020-09,30,4357,90,4267
Brunei,2020-10,31,4556,93,4463
Brunei,2020-11,6,888,18,870
Bulgaria,2020-01,10,0,0,0
Bulgaria,2020-02,29,0,0,0
Bulgaria,2020-03,31,3975,79,3896
Bulgaria,2020-04,30,26897,1169,25728
Bulgaria,2020-05,31,66835,3359,63476
Bulgaria,2020-06,30,108207,5590,102617
Bulgaria,2020-07,31,261634,9320,252314
Bulgaria,2020-08,31,448399,15888,432511
Bulgaria,2020-09,30,556756,22220,534536
Bulgaria,2020-10,31,994988,31210,963778
Bulgaria,2020-11,6,395562,8916,386646
Burkina Faso,2020-01,10,0,0,0
Burkina Faso,2020-02,29,0,0,0
Burkina Faso,2020-03,31,2162,100,2062
Burkina Faso,2020-04,30,15614,950,14664
Burkina Faso,2020-05,31,24215,1565,22650
Burkina Faso,2020-06,30,27235,1590,25645
Burkina Faso,2020-07,31,32455,1643,30812
Burkina Faso,2020-08,31,39136,1689,37447
Burkina Faso,2020-09,30,51847,1682,50165
Burkina Faso,2020-10,31,72702,1969,70733
Burkina Faso,2020-11,6,15260,402,14858
Burma,2020-03,12,70,2,68
Burma,2020-04,30,2544,115,2429
Burma,2020-05,31,5853,186,5667
Burma,2020-06,30,8093,180,7913
Burma,2020-07,31,10389,186,10203
Burma,2020-08,31,14391,186,14205
Burma,2020-09,30,162893,2827,160066
Burma,2020-10,31,1076870,25656,1051214
Burma,2020-11,6,344539,8044,336495
Burundi,2020-03,12,4,0,4
Burundi,2020-04,30,192,19,173
Burundi,2020-05,31,941,31,910
Burundi,2020-06,30,3326,30,3296
Burundi,2020-07,31,8814,31,8783
Burundi,2020-08,31,12965,31,12934
Burundi,2020-09,30,14234,30,14204
Burundi,2020-10,31,16727,31,16696
Burundi,2020-11,6,3614,6,3608
Cabo Verde,2020-03,12,54,9,45
Cabo Verde,2020-04,30,1538,30,1508
Cabo Verde,2020-05,31,9650,86,9564
Cabo Verde,2020-06,30,24274,229,24045
Cabo Verde,2020-07,31,59262,614,58648
Cabo Verde,2020-08,31,100133,1059,99074
Cabo Verde,2020-09,30,150769,1466,149303
Cabo Verde,2020-10,31,235287,2553,232734
Cabo Verde,2020-11,6,54531,582,53949
Cambodia,2020-01,31,6,0,6
Cambodia,2020-02,29,29,0,29
Cambodia,2020-03,31,1333,0,1333
Cambodia,2020-04,30,3596,0,3596
Cambodia,2020-05,31,3807,0,3807
Cambodia,2020-06,30,3901,0,3901
Cambodia,2020-07,31,5571,0,5571
Cambodia,2020-08,31,8208,0,8208
Cambodia,2020-09,30,8250,0,8250
Cambodia,2020-10,31,8823,0,8823
Cambodia,2020-11,6,1757,0,1757
Cameroon,2020-01,10,0,0,0
Cameroon,2020-02,29,0,0,0
Cameroon,2020-03,31,1260,30,1230
Cameroon,2020-04,30,32136,880,31256
Cameroon,2020-05,31,113576,4252,109324
Cameroon,2020-06,30,301771,7839,293932
Cameroon,2020-07,31,482273,11308,470965
Cameroon,2020-08,31,572112,12475,559637
Cameroon,2020-09,30,608107,12483,595624
Cameroon,2020-10,31,663444,13129,650315
Cameroon,2020-11,6,132928,2577,130351
Canada,2020-01,31,16,0,16
Canada,2020-02,29,250,0,250
Canada,2020-03,31,60522,665,59857
Canada,2020-04,30,975818,43838,931980
Canada,2020-05,31,2407742,178132,2229610
Canada,2020-06,30,3030051,247126,2782925
Canada,2020-07,31,3472369,274786,3197583
Canada,2020-08,31,3866688,281572,3585116
Canada,2020-09,30,4321079,277622,4043457
Canada,2020-10,31,6202422,304269,5898153
Canada,2020-11,6,1515358,62442,1452916
Central African Republic,2020-01,10,0,0,0
Central African Republic,2020-02,29,0,0,0
Central African Republic,2020-03,31,44,0,44
Central African Republic,2020-04,30,491,0,491
Central African Republic,2020-05,31,12300,12,12288
Central African Republic,2020-06,30,73499,604,72895
Central African Republic,2020-07,31,135350,1689,133661
Central African Republic,2020-08,31,144588,1877,142711
Central African Republic,2020-09,30,143170,1860,141310
Central African Republic,2020-10,31,150535,1922,148613
Central African Republic,2020-11,6,29196,372,28824
Chad,2020-01,10,0,0,0
Chad,2020-02,29,0,0,0
Chad,2020-03,31,42,0,42
Chad,2020-04,30,863,14,849
Chad,2020-05,31,14756,1405,13351
Chad,2020-06,30,25515,2164,23351
Chad,2020-07,31,27709,2315,25394
Chad,2020-08,31,30026,2360,27666
Chad,2020-09,30,33342,2425,30917
Chad,2020-10,31,42089,2875,39214
Chad,2020-11,6,9149,592,8557
Chile,2020-01,10,0,0,0
Chile,2020-02,29,0,0,0
Chile,2020-03,31,21343,62,21281
Chile,2020-04,30,300271,3489,296782
Chile,2020-05,31,1868963,16660,1852303
Chile,2020-06,30,6447138,106052,6341086
Chile,2020-07,31,10063873,243026,9820847
Chile,2020-08,31,11992108,325617,11666491
Chile,2020-09,30,13198389,363035,12835354
Chile,2020-10,31,15182023,420713,14761310
Chile,2020-11,6,3097354,86305,3011049
China,2020-01,31,49613,1126,48487
China,2020-02,29,1702915,49041,1653874
China,2020-03,31,2518349,98960,2419389
China,2020-04,30,2501820,119618,2382202
China,2020-05,31,2605471,143764,2461707
China,2020-06,30,2533318,139168,2394150
China,2020-07,31,2657813,144056,2513757
China,2020-08,31,2766700,145726,2620974
China,2020-09,30,2708082,142051,2566031
China,2020-10,31,2819798,146909,2672889
China,2020-11,6,549204,28441,520763
Colombia,2020-01,10,0,0,0
Colombia,2020-02,29,0,0,0
Colombia,2020-03,31,7068,84,6984
Colombia,2020-04,30,107305,4526,102779
Colombia,2020-05,31,515090,18622,496468
Colombia,2020-06,30,1814371,59663,1754708
Colombia,2020-07,31,5877917,202434,5675483
Colombia,2020-08,31,14735230,476085,14259145
Colombia,2020-09,30,22165940,703847,21462093
Colombia,2020-11,6,6683314,192733,6490581
Comoros,2020-03,12,0,0,0
Comoros,2020-04,30,2,0,2
Comoros,2020-05,31,1221,33,1188
Comoros,2020-06,30,6158,122,6036
Comoros,2020-07,31,10308,217,10091
Comoros,2020-08,31,12625,217,12408
Comoros,2020-09,30,13919,210,13709
Comoros,2020-10,31,15674,217,15457
Comoros,2020-11,6,3315,42,3273
Congo (Brazzaville),2020-01,10,0,0,0
Congo (Brazzaville),2020-02,29,0,0,0
Congo (Brazzaville),2020-03,31,116,0,116
Congo (Brazzaville),2020-04,30,3620,166,3454
Congo (Brazzaville),2020-05,31,12496,438,12058
Congo (Brazzaville),2020-06,30,25936,849,25087
Congo (Brazzaville),2020-07,31,75441,1513,73928
Congo (Brazzaville),2020-08,31,117292,2133,115159
Congo (Brazzaville),2020-09,30,147402,2785,144617
Congo (Brazzaville),2020-10,31,160198,2821,157377
Congo (Brazzaville),2020-11,6,32092,552,31540
Congo (Kinshasa),2020-01,10,0,0,0
Congo (Kinshasa),2020-02,29,0,0,0
Congo (Kinshasa),2020-03,31,740,49,691
Congo (Kinshasa),2020-04,30,9113,682,8431
Congo (Kinshasa),2020-05,31,50726,1669,49057
Congo (Kinshasa),2020-06,30,156487,3512,152975
Congo (Kinshasa),2020-07,31,255492,6039,249453
Congo (Kinshasa),2020-08,31,299449,7387,292062
Congo (Kinshasa),2020-09,30,312707,7983,304724
Congo (Kinshasa),2020-10,31,340996,9035,331961
Congo (Kinshasa),2020-11,6,68823,1884,66939
Costa Rica,2020-01,10,0,0,0
Costa Rica,2020-02,29,0,0,0
Costa Rica,2020-03,31,3334,26,3308
Costa Rica,2020-04,30,18238,126,18112
Costa Rica,2020-05,31,27034,264,26770
Costa Rica,2020-06,30,60722,362,60360
Costa Rica,2020-07,31,323897,1957,321940
Costa Rica,2020-08,31,914009,9441,904568
Costa Rica,2020-09,30,1805698,20024,1785674
Costa Rica,2020-10,31,2935310,36385,2898925
Costa Rica,2020-11,6,681839,8604,673235
Cote d'Ivoire,2020-01,10,0,0,0
Cote d'Ivoire,2020-02,29,0,0,0
Cote d'Ivoire,2020-03,31,1230,4,1226
Cote d'Ivoire,2020-04,30,22030,239,21791
Cote d'Ivoire,2020-05,31,64626,791,63835
Cote d'Ivoire,2020-06,30,183660,1478,182182
Cote d'Ivoire,2020-07,31,419114,2706,416408
Cote d'Ivoire,2020-08,31,530785,3391,527394
Cote d'Ivoire,2020-09,30,573131,3587,569544
Cote d'Ivoire,2020-10,31,628293,3759,624534
Cote d'Ivoire,2020-11,6,124687,756,123931
Croatia,2020-01,31,0,0,0
Croatia,2020-02,29,24,0,24
Croatia,2020-03,31,7265,42,7223
Croatia,2020-04,30,50855,1106,49749
Croatia,2020-05,31,68304,2911,65393
Croatia,2020-06,30,70862,3182,67680
Croatia,2020-07,31,127173,3846,123327
Croatia,2020-08,31,222483,5164,217319
Croatia,2020-09,30,421677,7054,414623
Croatia,2020-10,31,864295,11844,852451
Croatia,2020-11,6,349518,4009,345509
Cruise Ship,2020-01,10,0,0,0
Cruise Ship,2020-02,29,10781,41,10740
Cruise Ship,2020-03,19,13311,124,13187
Cuba,2020-01,10,0,0,0
Cuba,2020-02,29,0,0,0
Cuba,2020-03,31,1206,34,1172
Cuba,2020-04,30,26753,917,25836
Cuba,2020-05,31,57494,2411,55083
Cuba,2020-06,30,67725,2530,65195
Cuba,2020-07,31,76124,2688,73436
Cuba,2020-08,31,104045,2774,101271
Cuba,2020-09,30,146773,3328,143445
Cuba,2020-10,31,193686,3882,189804
Cuba,2020-11,6,42837,776,42061
Cyprus,2020-01,10,0,0,0
Cyprus,2020-02,29,0,0,0
Cyprus,2020-03,31,2351,49,2302
Cyprus,2020-04,30,20434,361,20073
Cyprus,2020-05,31,28303,508,27795
Cyprus,2020-06,30,29420,550,28870
Cyprus,2020-07,31,32133,589,31544
Cyprus,2020-08,31,41746,611,41135
Cyprus,2020-09,30,47624,656,46968
Cyprus,2020-10,31,85501,761,84740
Cyprus,2020-11,6,31438,162,31276
Czechia,2020-01,31,0,0,0
Czechia,2020-02,29,0,0,0
Czechia,2020-03,31,29292,141,29151
Czechia,2020-04,30,188375,4787,183588
Czechia,2020-05,31,264565,9102,255463
Czechia,2020-06,30,310575,10046,300529
Czechia,2020-07,31,435362,11179,424183
Czechia,2020-08,31,636591,12471,624120
Czechia,2020-09,30,1350756,15203,1335553
Czechia,2020-10,31,5707546,49860,5657686
Czechia,2020-11,6,2298078,25176,2272902
Denmark,2020-01,31,0,0,0
Denmark,2020-02,29,8,0,8
Denmark,2020-03,31,35758,632,35126
Denmark,2020-04,30,209864,9455,200409
Denmark,2020-05,31,341335,16761,324574
Denmark,2020-06,30,374467,17898,356569
Denmark,2020-07,31,415752,18928,396824
Denmark,2020-08,31,494171,19239,474932
Denmark,2020-09,30,669253,19091,650162
Denmark,2020-10,31,1134626,21215,1113411
Denmark,2020-11,6,310498,4392,306106
Diamond Princess,2020-03,12,8544,114,8430
Diamond Princess,2020-04,30,21360,364,20996
Diamond Princess,2020-05,31,22072,403,21669
Diamond Princess,2020-06,30,21360,390,20970
Diamond Princess,2020-07,31,22072,403,21669
Diamond Princess,2020-08,31,22072,403,21669
Diamond Princess,2020-09,30,21360,390,20970
Diamond Princess,2020-10,31,22072,403,21669
Diamond Princess,2020-11,6,4272,78,4194
Djibouti,2020-01,10,0,0,0
Djibouti,2020-02,29,0,0,0
Djibouti,2020-03,31,155,0,155
Djibouti,2020-04,30,17342,43,17299
Djibouti,2020-05,31,56519,266,56253
Djibouti,2020-06,30,133501,1240,132261
Djibouti,2020-07,31,154097,1752,152345
Djibouti,2020-08,31,165942,1841,164101
Djibouti,2020-09,30,161989,1826,160163
Djibouti,2020-10,31,169786,1891,167895
Djibouti,2020-11,6,33537,366,33171
Dominica,2020-03,12,91,0,91
Dominica,2020-04,30,464,0,464
Dominica,2020-05,31,496,0,496
Dominica,2020-06,30,540,0,540
Dominica,2020-07,31,558,0,558
Dominica,2020-08,31,578,0,578
Dominica,2020-09,30,728,0,728
Dominica,2020-10,31,1081,0,1081
Dominica,2020-11,6,321,0,321
Dominican Republic,2020-01,31,0,0,0
Dominican Republic,2020-02,29,0,0,0
Dominican Republic,2020-03,31,7249,271,6978
Dominican Republic,2020-04,30,121795,5802,115993
Dominican Republic,2020-05,31,386714,13183,373531
Dominican Republic,2020-06,30,737245,18649,718596
Dominican Republic,2020-07,31,1580515,29571,1550944
Dominican Republic,2020-08,31,2655854,45100,2610754
Dominican Republic,2020-09,30,3161050,59625,3101425
Dominican Republic,2020-10,31,3742000,67948,3674052
Dominican Republic,2020-11,6,771455,13545,757910
Ecuador,2020-01,31,0,0,0
Ecuador,2020-02,29,0,0,0
Ecuador,2020-03,31,18709,498,18211
Ecuador,2020-04,30,343855,13411,330444
Ecuador,2020-05,31,1043478,79321,964157
Ecuador,2020-06,30,1447079,120000,1327079
Ecuador,2020-07,31,2245927,161656,2084271
Ecuador,2020-08,31,3150202,190494,2959708
Ecuador,2020-09,30,3701439,309483,3391956
Ecuador,2020-10,31,4745679,380518,4365161
Ecuador,2020-11,6,1028906,76360,952546
Egypt,2020-01,31,0,0,0
Egypt,2020-02,29,17,0,17
Egypt,2020-03,31,7849,384,7465
Egypt,2020-04,30,88213,6363,81850
Egypt,2020-05,31,423441,20114,403327
Egypt,2020-06,30,1450173,56753,1393420
Egypt,2020-07,31,2641342,127125,2514217
Egypt,2020-08,31,2995927,159976,2835951
Egypt,2020-09,30,3043099,171179,2871920
Egypt,2020-10,31,3267816,189547,3078269
Egypt,2020-11,6,650595,37941,612654
El Salvador,2020-01,10,0,0,0
El Salvador,2020-02,29,0,0,0
El Salvador,2020-03,31,188,2,186
El Salvador,2020-04,30,5696,190,5506
El Salvador,2020-05,31,43384,845,42539
El Salvador,2020-06,30,126705,2766,123939
El Salvador,2020-07,31,357844,9808,348036
El Salvador,2020-08,31,701210,18923,682287
El Salvador,2020-09,30,821521,23851,797670
El Salvador,2020-10,31,971990,28393,943597
El Salvador,2020-11,6,207329,5967,201362
Equatorial Guinea,2020-01,10,0,0,0
Equatorial Guinea,2020-02,29,0,0,0
Equatorial Guinea,2020-03,31,142,0,142
Equatorial Guinea,2020-04,30,3170,10,3160
Equatorial Guinea,2020-05,31,22833,230,22603
Equatorial Guinea,2020-06,30,47267,680,46587
Equatorial Guinea,2020-07,31,98701,1645,97056
Equatorial Guinea,2020-08,31,150932,2573,148359
Equatorial Guinea,2020-09,30,150064,2490,147574
Equatorial Guinea,2020-10,31,157137,2573,154564
Equatorial Guinea,2020-11,6,30543,504,30039
Eritrea,2020-03,12,80,0,80
Eritrea,2020-04,30,1051,0,1051
Eritrea,2020-05,31,1209,0,1209
Eritrea,2020-06,30,3247,0,3247
Eritrea,2020-07,31,7566,0,7566
Eritrea,2020-08,31,9218,0,9218
Eritrea,2020-09,30,10720,0,10720
Eritrea,2020-10,31,13434,0,13434
Eritrea,2020-11,6,2892,0,2892
Estonia,2020-01,31,0,0,0
Estonia,2020-02,29,4,0,4
Estonia,2020-03,31,8094,18,8076
Estonia,2020-04,30,42019,1026,40993
Estonia,2020-05,31,55185,1919,53266
Estonia,2020-06,30,58845,2069,56776
Estonia,2020-07,31,62617,2139,60478
Estonia,2020-08,31,68792,1962,66830
Estonia,2020-09,30,84983,1920,83063
Estonia,2020-10,31,127333,2160,125173
Estonia,2020-11,6,32458,438,32020
Eswatini,2020-01,10,0,0,0
Eswatini,2020-02,29,0,0,0
Eswatini,2020-03,31,84,0,84
Eswatini,2020-04,30,934,16,918
Eswatini,2020-05,31,6322,58,6264
Eswatini,2020-06,30,16309,159,16150
Eswatini,2020-07,31,52339,731,51608
Eswatini,2020-08,31,117631,2237,115394
Eswatini,2020-09,30,154490,3053,151437
Eswatini,2020-10,31,178160,3554,174606
Eswatini,2020-11,6,35753,702,35051
Ethiopia,2020-01,10,0,0,0
Ethiopia,2020-02,29,0,0,0
Ethiopia,2020-03,31,229,0,229
Ethiopia,2020-04,30,2663,76,2587
Ethiopia,2020-05,31,13814,167,13647
Ethiopia,2020-06,30,111281,1775,109506
Ethiopia,2020-07,31,312626,5172,307454
Ethiopia,2020-08,31,1033158,17351,1015807
Ethiopia,2020-09,30,1987960,31430,1956530
Ethiopia,2020-10,31,2724537,41702,2682835
Ethiopia,2020-11,6,588622,9027,579595
Fiji,2020-01,10,0,0,0
Fiji,2020-02,29,0,0,0
Fiji,2020-03,31,52,0,52
Fiji,2020-04,30,477,0,477
Fiji,2020-05,31,558,0,558
Fiji,2020-06,30,540,0,540
Fiji,2020-07,31,774,2,772
Fiji,2020-08,31,857,37,820
Fiji,2020-09,30,948,60,888
Fiji,2020-10,31,1008,62,946
Fiji,2020-11,6,204,12,192
Finland,2020-01,31,4,0,4
Finland,2020-02,29,36,0,36
Finland,2020-03,31,14797,86,14711
Finland,2020-04,30,103050,3057,99993
Finland,2020-05,31,192479,8893,183586
Finland,2020-06,30,212751,9758,202993
Finland,2020-07,31,227155,10189,216966
Finland,2020-08,31,241015,10330,230685
Finland,2020-09,30,267337,10183,257154
Finland,2020-10,31,409861,10863,398998
Finland,2020-11,6,102034,2164,99870
France,2020-01,31,35,0,35
France,2020-02,29,561,21,540
France,2020-03,31,464421,24959,439462
France,2020-04,30,3836624,507661,3328963
France,2020-11,6,9767578,233279,9534299
Gabon,2020-01,10,0,0,0
Gabon,2020-02,29,0,0,0
Gabon,2020-03,31,102,13,89
Gabon,2020-04,30,3366,47,3319
Gabon,2020-05,31,43264,334,42930
Gabon,2020-06,30,122978,903,122075
Gabon,2020-07,31,197565,1445,196120
Gabon,2020-08,31,253863,1613,252250
Gabon,2020-09,30,260054,1601,258453
Gabon,2020-10,31,275262,1679,273583
Gabon,2020-11,6,54022,330,53692
Gambia,2020-03,12,35,10,25
Gambia,2020-04,30,240,30,210
Gambia,2020-05,31,694,31,663
Gambia,2020-06,30,1040,42,998
Gambia,2020-07,31,4883,138,4745
Gambia,2020-08,31,59153,1805,57348
Gambia,2020-09,30,102345,3157,99188
Gambia,2020-10,31,112872,3652,109220
Gambia,2020-11,6,22080,721,21359
"Gambia, The",2020-01,10,0,0,0
"Gambia, The",2020-02,29,0,0,0
"Gambia, The",2020-03,19,4,0,4
Georgia,2020-01,31,0,0,0
Georgia,2020-02,29,5,0,5
Georgia,2020-03,31,1365,0,1365
Georgia,2020-04,30,10196,110,10086
Georgia,2020-05,31,21175,345,20830
Georgia,2020-06,30,26111,413,25698
Georgia,2020-07,31,32157,482,31675
Georgia,2020-08,31,41342,544,40798
Georgia,2020-09,30,96644,684,95960
Georgia,2020-10,31,606139,4533,601606
Georgia,2020-11,6,288913,2360,286553
Germany,2020-01,31,23,0,23
Germany,2020-02,29,635,0,635
Germany,2020-03,31,659908,4651,655257
Germany,2020-04,30,4034126,121118,3913008
Germany,2020-05,31,5448216,244909,5203307
Germany,2020-06,30,5682770,264731,5418039
Germany,2020-07,31,6280060,281617,5998443
Germany,2020-08,31,7059136,286406,6772730
Germany,2020-09,30,8071632,281647,7789985
Germany,2020-10,31,11891919,305632,11586287
Germany,2020-11,6,3707052,65955,3641097
Ghana,2020-01,10,0,0,0
Ghana,2020-02,29,0,0,0
Ghana,2020-03,31,1307,43,1264
Ghana,2020-04,30,25942,266,25676
Ghana,2020-05,31,170579,839,169740
Ghana,2020-06,30,380404,2094,378310
Ghana,2020-07,31,844104,4548,839556
Ghana,2020-08,31,1304975,7378,1297597
Ghana,2020-09,30,1370401,8750,1361651
Ghana,2020-10,31,1467315,9628,1457687
Ghana,2020-11,6,291476,1920,289556
Greece,2020-01,31,0,0,0
Greece,2020-02,29,16,0,16
Greece,2020-03,31,14707,388,14319
Greece,2020-04,30,65594,3179,62415
Greece,2020-05,31,86710,4993,81717
Greece,2020-06,30,95359,5584,89775
Greece,2020-07,31,122199,6092,116107
Greece,2020-08,31,228246,7172,221074
Greece,2020-09,30,432359,9831,422528
Greece,2020-10,31,823744,15681,808063
Greece,2020-11,6,289211,4111,285100
Grenada,2020-03,12,61,0,61
Grenada,2020-04,30,440,0,440
Grenada,2020-05,31,677,0,677
Grenada,2020-06,30,690,0,690
Grenada,2020-07,31,716,0,716
Grenada,2020-08,31,744,0,744
Grenada,2020-09,30,720,0,720
Grenada,2020-10,31,806,0,806
Grenada,2020-11,6,178,0,178
Guatemala,2020-01,10,0,0,0
Guatemala,2020-02,29,0,0,0
Guatemala,2020-03,31,371,17,354
Guatemala,2020-04,30,7873,220,7653
Guatemala,2020-05,31,71590,1410,70180
Guatemala,2020-06,30,342558,13414,329144
Guatemala,2020-07,31,1093776,43404,1050372
Guatemala,2020-08,31,1962998,74712,1888286
Guatemala,2020-09,30,2513536,91014,2422522
Guatemala,2020-10,31,3122296,108417,3013879
Guatemala,2020-11,6,656752,22601,634151
Guinea,2020-01,10,0,0,0
Guinea,2020-02,29,0,0,0
Guinea,2020-03,31,126,0,126
Guinea,2020-04,30,17428,91,17337
Guinea,2020-05,31,83054,488,82566
Guinea,2020-06,30,140762,789,139973
Guinea,2020-07,31,198402,1218,197184
Guinea,2020-08,31,263447,1629,261818
Guinea,2020-09,30,304790,1905,302885
Guinea,2020-10,31,352324,2159,350165
Guinea,2020-11,6,73969,439,73530
Guinea-Bissau,2020-03,12,34,0,34
Guinea-Bissau,2020-04,30,1712,6,1706
Guinea-Bissau,2020-05,31,27974,140,27834
Guinea-Bissau,2020-06,30,44759,478,44281
Guinea-Bissau,2020-07,31,58366,797,57569
Guinea-Bissau,2020-08,31,65461,967,64494
Guinea-Bissau,2020-09,30,68532,1154,67378
Guinea-Bissau,2020-10,31,74166,1258,72908
Guinea-Bissau,2020-11,6,14482,250,14232
Guyana,2020-01,10,0,0,0
Guyana,2020-02,29,0,0,0
Guyana,2020-03,31,153,23,130
Guyana,2020-04,30,1632,190,1442
Guyana,2020-05,31,3688,318,3370
Guyana,2020-06,30,5490,360,5130
Guyana,2020-07,31,10147,555,9592
Guyana,2020-08,31,24986,834,24152
Guyana,2020-09,30,63178,1810,61368
Guyana,2020-10,31,113695,3354,110341
Guyana,2020-11,6,26160,784,25376
Haiti,2020-03,12,109,0,109
Haiti,2020-04,30,1431,100,1331
Haiti,2020-05,31,20543,691,19852
Haiti,2020-06,30,134221,2294,131927
Haiti,2020-07,31,213853,4378,209475
Haiti,2020-08,31,244230,5880,238350
Haiti,2020-09,30,256255,6598,249657
Haiti,2020-10,31,277171,7151,270020
Haiti,2020-11,6,54577,1392,53185
Holy See,2020-01,10,0,0,0
Holy See,2020-02,29,0,0,0
Holy See,2020-03,31,64,0,64
Holy See,2020-04,30,252,0,252
Holy See,2020-05,31,368,0,368
Holy See,2020-06,30,360,0,360
Holy See,2020-07,31,372,0,372
Holy See,2020-08,31,372,0,372
Holy See,2020-09,30,360,0,360
Holy See,2020-10,31,661,0,661
Holy See,2020-11,6,162,0,162
Honduras,2020-01,10,0,0,0
Honduras,2020-02,29,0,0,0
Honduras,2020-03,31,962,27,935
Honduras,2020-04,30,13937,1171,12766
Honduras,2020-05,31,90737,4463,86274
Honduras,2020-06,30,332027,10460,321567
Honduras,2020-07,31,997778,28279,969499
Honduras,2020-08,31,1603516,49824,1553692
Honduras,2020-09,30,2090768,64194,2026574
Honduras,2020-10,31,2724304,79180,2645124
Honduras,2020-11,6,596040,16348,579692
Hungary,2020-01,10,0,0,0
Hungary,2020-02,29,0,0,0
Hungary,2020-03,31,4004,135,3869
Hungary,2020-04,30,51141,4778,46363
Hungary,2020-05,31,107818,13832,93986
Hungary,2020-06,30,121952,16878,105074
Hungary,2020-07,31,133747,18410,115337
Hungary,2020-08,31,156330,18839,137491
Hungary,2020-09,30,470661,20162,450499
Hungary,2020-10,31,1475395,36617,1438778
Hungary,2020-11,6,558581,12641,545940
Iceland,2020-01,31,0,0,0
Iceland,2020-02,29,3,0,3
Iceland,2020-03,31,12432,24,12408
Iceland,2020-04,30,50804,242,50562
Iceland,2020-05,31,55873,310,55563
Iceland,2020-06,30,54380,300,54080
Iceland,2020-07,31,57109,310,56799
Iceland,2020-08,31,62460,310,62150
Iceland,2020-09,30,69725,300,69425
Iceland,2020-10,31,121265,332,120933
Iceland,2020-11,6,29997,100,29897
India,2020-01,31,3,0,3
India,2020-02,29,86,0,86
India,2020-03,31,11646,261,11385
India,2020-04,30,481073,15536,465537
India,2020-05,31,3244240,98408,3145832
India,2020-06,30,11346585,343848,11002737
India,2020-11,6,50326700,747628,49579072
Indonesia,2020-01,31,0,0,0
Indonesia,2020-02,29,0,0,0
Indonesia,2020-03,31,13499,1125,12374
Indonesia,2020-04,30,173559,14723,158836
Indonesia,2020-05,31,562530,36580,525950
Indonesia,2020-06,30,1241769,67823,1173946
Indonesia,2020-07,31,2596123,125217,2470906
Indonesia,2020-08,31,4402544,194891,4207653
Indonesia,2020-09,30,6991737,275847,6715890
Indonesia,2020-10,31,11052021,386438,10665583
Indonesia,2020-11,6,2543148,85755,2457393
Iran,2020-01,31,0,0,0
Iran,2020-02,29,2210,214,1996
Iran,2020-03,31,569959,37055,532904
Iran,2020-04,30,2305872,144453,2161419
Iran,2020-05,31,3784814,217434,3567380
Iran,2020-06,30,5825642,276962,5548680
Iran,2020-07,31,8355890,430609,7925281
Iran,2020-08,31,10693750,609789,10083961
Iran,2020-09,30,12447988,715707,11732281
Iran,2020-11,6,3902911,220714,3682197
Iraq,2020-01,31,0,0,0
Iraq,2020-02,29,47,0,47
Iraq,2020-03,31,7016,559,6457
Iraq,2020-04,30,43885,2318,41567
Iraq,2020-05,31,116668,4197,112471
Iraq,2020-06,30,774574,26934,747640
Iraq,2020-07,31,2755551,110675,2644876
Iraq,2020-08,31,5626863,185308,5441555
Iraq,2020-09,30,9153210,247952,8905258
Iraq,2020-10,31,13158430,315268,12843162
Iraq,2020-11,6,2925374,66932,2858442
Ireland,2020-01,31,0,0,0
Ireland,2020-02,29,2,0,2
Ireland,2020-03,31,26542,367,26175
Ireland,2020-04,30,383237,17821,365416
Ireland,2020-05,31,735055,47100,687955
Ireland,2020-06,30,759422,51173,708249
Ireland,2020-07,31,797688,54304,743384
Ireland,2020-08,31,850427,54974,795453
Ireland,2020-09,30,965538,53663,911875
Ireland,2020-10,31,1520771,57425,1463346
Ireland,2020-11,6,382949,11584,371365
Israel,2020-01,31,0,0,0
Israel,2020-02,29,28,0,28
Israel,2020-03,31,38699,114,38585
Israel,2020-04,30,371513,4162,367351
Israel,2020-05,31,515185,8227,506958
Israel,2020-06,30,607634,9117,598517
Israel,2020-07,31,1492122,12508,1479614
Israel,2020-08,31,2950222,22621,2927601
Israel,2020-09,30,5308291,36548,5271743
Israel,2020-10,31,9225274,66756,9158518
Israel,2020-11,6,1904684,15711,1888973
Italy,2020-01,31,4,0,4
Italy,2020-02,29,5092,131,4961
Italy,2020-03,31,1314436,129015,1185421
Italy,2020-04,30,5028195,659710,4368485
Italy,2020-11,6,4861940,239911,4622029
Jamaica,2020-01,10,0,0,0
Jamaica,2020-02,29,0,0,0
Jamaica,2020-03,31,418,14,404
Jamaica,2020-04,30,5397,154,5243
Jamaica,2020-05,31,16247,278,15969
Jamaica,2020-06,30,19174,299,18875
Jamaica,2020-07,31,24487,310,24177
Jamaica,2020-08,31,42509,478,42031
Jamaica,2020-09,30,134391,1750,132641
Jamaica,2020-10,31,250341,5030,245311
Jamaica,2020-11,6,56141,1294,54847
Japan,2020-01,31,77,0,77
Japan,2020-02,29,2583,33,2550
Japan,2020-03,31,30807,927,29880
Japan,2020-04,30,276189,7242,268947
Japan,2020-05,31,498951,23487,475464
Japan,2020-06,30,527473,28211,499262
Japan,2020-07,31,789214,30645,758569
Japan,2020-08,31,1734078,35164,1698914
Japan,2020-09,30,2312377,44097,2268280
Japan,2020-10,31,2873957,51765,2822192
Japan,2020-11,6,627520,10813,616707
Jordan,2020-01,10,0,0,0
Jordan,2020-02,29,0,0,0
Jordan,2020-03,31,2695,20,2675
Jordan,2020-04,30,11995,203,11792
Jordan,2020-05,31,19087,279,18808
Jordan,2020-06,30,28907,270,28637
Jordan,2020-07,31,36406,324,36082
Jordan,2020-08,31,46329,376,45953
Jordan,2020-09,30,150197,906,149291
Jordan,2020-10,31,1199611,11784,1187827
Jordan,2020-11,6,561172,6287,554885
Kazakhstan,2020-01,10,0,0,0
Kazakhstan,2020-02,29,0,0,0
Kazakhstan,2020-03,31,2279,12,2267
Kazakhstan,2020-04,30,49278,465,48813
Kazakhstan,2020-05,31,210217,1039,209178
Kazakhstan,2020-06,30,488057,3089,484968
Kazakhstan,2020-07,31,2124544,13981,2110563
Kazakhstan,2020-08,31,3160195,39964,3120231
Kazakhstan,2020-09,30,3212328,49796,3162532
Kazakhstan,2020-10,31,3400378,55020,3345358
Kazakhstan,2020-11,6,687431,11142,676289
Kenya,2020-01,10,0,0,0
Kenya,2020-02,29,0,0,0
Kenya,2020-03,31,429,7,422
Kenya,2020-04,30,7600,313,7287
Kenya,2020-05,31,31339,1361,29978
Kenya,2020-06,30,123228,3299,119929
Kenya,2020-07,31,400898,7100,393798
Kenya,2020-08,31,916138,15115,901023
Kenya,2020-09,30,1096210,19227,1076983
Kenya,2020-10,31,1401966,25864,1376102
Kenya,2020-11,6,353969,6407,347562
"Korea, South",2020-01,31,49,0,49
"Korea, South",2020-02,29,15267,99,15168
"Korea, South",2020-03,31,251554,2752,248802
"Korea, South",2020-04,30,316419,6619,309800
"Korea, South",2020-05,31,343688,8127,335561
"Korea, South",2020-06,30,367152,8348,358804
"Korea, South",2020-07,31,424907,9076,415831
"Korea, South",2020-08,31,511295,9580,501715
"Korea, South",2020-09,30,676877,11171,665706
"Korea, South",2020-10,31,783181,13762,769419
"Korea, South",2020-11,6,162642,2853,159789
Kosovo,2020-01,10,0,0,0
Kosovo,2020-02,29,0,0,0
Kosovo,2020-03,31,885,10,875
Kosovo,2020-04,30,13425,337,13088
Kosovo,2020-05,31,29614,871,28743
Kosovo,2020-06,30,53582,1067,52515
Kosovo,2020-07,31,171962,4018,167944
Kosovo,2020-08,31,354960,12511,342449
Kosovo,2020-09,30,444477,17898,426579
Kosovo,2020-10,31,528348,20236,508112
Kosovo,2020-11,6,130797,4291,126506
Kuwait,2020-01,31,0,0,0
Kuwait,2020-02,29,216,0,216
Kuwait,2020-03,31,4398,0,4398
Kuwait,2020-04,30,55103,260,54843
Kuwait,2020-05,31,468835,3474,465361
Kuwait,2020-06,30,1125924,9032,1116892
Kuwait,2020-07,31,1797179,12543,1784636
Kuwait,2020-08,31,2380778,15475,2365303
Kuwait,2020-09,30,2905832,17174,2888658
Kuwait,2020-10,31,3590620,21616,3569004
Kuwait,2020-11,6,775388,4779,770609
Kyrgyzstan,2020-01,10,0,0,0
Kyrgyzstan,2020-02,29,0,0,0
Kyrgyzstan,2020-03,31,694,0,694
Kyrgyzstan,2020-04,30,13899,162,13737
Kyrgyzstan,2020-05,31,37452,415,37037
Kyrgyzstan,2020-06,30,91603,1018,90585
Kyrgyzstan,2020-07,31,627821,20180,607641
Kyrgyzstan,2020-08,31,1284233,40612,1243621
Kyrgyzstan,2020-09,30,1356792,31868,1324924
Kyrgyzstan,2020-10,31,1617742,34244,1583498
Kyrgyzstan,2020-11,6,366767,6992,359775
Laos,2020-03,12,59,0,59
Laos,2020-04,30,513,0,513
Laos,2020-05,31,589,0,589
Laos,2020-06,30,570,0,570
Laos,2020-07,31,598,0,598
Laos,2020-08,31,658,0,658
Laos,2020-09,30,681,0,681
Laos,2020-10,31,725,0,725
Laos,2020-11,6,144,0,144
Latvia,2020-01,10,0,0,0
Latvia,2020-02,29,0,0,0
Latvia,2020-03,31,3675,0,3675
Latvia,2020-04,30,20609,200,20409
Latvia,2020-05,31,30610,622,29988
Latvia,2020-06,30,33023,841,32182
Latvia,2020-07,31,36600,952,35648
Latvia,2020-08,31,40919,1013,39906
Latvia,2020-09,30,46000,1066,44934
Latvia,2020-10,31,110334,1493,108841
Latvia,2020-11,6,41772,522,41250
Lebanon,2020-01,31,0,0,0
Lebanon,2020-02,29,19,0,19
Lebanon,2020-03,31,5632,122,5510
Lebanon,2020-04,30,19199,628,18571
Lebanon,2020-05,31,29694,802,28892
Lebanon,2020-06,30,45140,941,44199
Lebanon,2020-07,31,88584,1315,87269
Lebanon,2020-08,31,315653,3338,312315
Lebanon,2020-09,30,829804,8097,821707
Lebanon,2020-10,31,1901004,15873,1885131
Lebanon,2020-11,6,529234,4084,525150
Lesotho,2020-03,12,0,0,0
Lesotho,2020-04,30,0,0,0
Lesotho,2020-05,31,31,0,31
Lesotho,2020-06,30,297,0,297
Lesotho,2020-07,31,9359,162,9197
Lesotho,2020-08,31,28290,832,27458
Lesotho,2020-09,30,40317,992,39325
Lesotho,2020-10,31,57252,1302,55950
Lesotho,2020-11,6,11782,264,11518
Liberia,2020-01,10,0,0,0
Liberia,2020-02,29,0,0,0
Liberia,2020-03,31,44,0,44
Liberia,2020-04,30,2194,218,1976
Liberia,2020-05,31,7045,698,6347
Liberia,2020-06,30,15908,971,14937
Liberia,2020-07,31,32493,1821,30672
Liberia,2020-08,31,39223,2507,36716
Liberia,2020-09,30,39781,2460,37321
Liberia,2020-10,31,42841,2542,40299
Liberia,2020-11,6,8634,492,8142
Libya,2020-03,12,43,0,43
Libya,2020-04,30,1231,41,1190
Libya,2020-05,31,2435,104,2331
Libya,2020-06,30,14943,335,14608
Libya,2020-07,31,60588,1496,59092
Libya,2020-08,31,267591,4998,262593
Libya,2020-09,30,760498,12053,748445
Libya,2020-10,31,1501972,22016,1479956
Libya,2020-11,6,390460,5424,385036
Liechtenstein,2020-01,10,0,0,0
Liechtenstein,2020-02,29,0,0,0
Liechtenstein,2020-03,31,762,0,762
Liechtenstein,2020-04,30,2386,28,2358
Liechtenstein,2020-05,31,2542,31,2511
Liechtenstein,2020-06,30,2460,30,2430
Liechtenstein,2020-07,31,2640,31,2609
Liechtenstein,2020-08,31,2971,31,2940
Liechtenstein,2020-09,30,3363,30,3333
Liechtenstein,2020-10,31,7976,36,7940
Liechtenstein,2020-11,6,4080,18,4062
Lithuania,2020-01,31,0,0,0
Lithuania,2020-02,29,3,0,3
Lithuania,2020-03,31,4159,55,4104
Lithuania,2020-04,30,34332,882,33450
Lithuania,2020-05,31,47863,1769,46094
Lithuania,2020-06,30,52984,2250,50734
Lithuania,2020-07,31,59703,2463,57240
Lithuania,2020-08,31,76638,2558,74080
Lithuania,2020-09,30,109257,2629,106628
Lithuania,2020-10,31,255055,3675,251380
Lithuania,2020-11,6,113581,1098,112483
Luxembourg,2020-01,31,0,0,0
Luxembourg,2020-02,29,2,0,2
Luxembourg,2020-03,31,19386,185,19201
Luxembourg,2020-04,30,100923,2010,98913
Luxembourg,2020-05,31,121945,3248,118697
Luxembourg,2020-06,30,123231,3300,119931
Luxembourg,2020-07,31,168782,3450,165332
Luxembourg,2020-08,31,225709,3790,221919
Luxembourg,2020-09,30,227028,3720,223308
Luxembourg,2020-10,31,360234,4231,356003
Luxembourg,2020-11,6,123838,1035,122803
MS Zaandam,2020-03,12,10,0,10
MS Zaandam,2020-04,30,277,62,215
MS Zaandam,2020-05,31,279,62,217
MS Zaandam,2020-06,30,270,60,210
MS Zaandam,2020-07,31,279,62,217
MS Zaandam,2020-08,31,279,62,217
MS Zaandam,2020-09,30,270,60,210
MS Zaandam,2020-10,31,279,62,217
MS Zaandam,2020-11,6,54,12,42
Madagascar,2020-03,12,325,0,325
Madagascar,2020-04,30,3214,0,3214
Madagascar,2020-05,31,11438,45,11393
Madagascar,2020-06,30,43660,370,43290
Madagascar,2020-07,31,201561,1793,199768
Madagascar,2020-08,31,424608,5063,419545
Madagascar,2020-09,30,475375,6470,468905
Madagascar,2020-10,31,520589,7393,513196
Madagascar,2020-11,6,102666,1464,101202
Malawi,2020-03,12,0,0,0
Malawi,2020-04,30,565,56,509
Malawi,2020-05,31,2994,102,2892
Malawi,2020-06,30,20314,233,20081
Malawi,2020-07,31,85254,1790,83464
Malawi,2020-08,31,156373,4869,151504
Malawi,2020-09,30,170940,5329,165611
Malawi,2020-10,31,181397,5627,175770
Malawi,2020-11,6,35627,1104,34523
Malaysia,2020-01,31,46,0,46
Malaysia,2020-02,29,546,0,546
Malaysia,2020-03,31,30377,307,30070
Malaysia,2020-04,30,148276,2452,145824
Malaysia,2020-05,31,216596,3456,213140
Malaysia,2020-06,30,253545,3582,249963
Malaysia,2020-07,31,272303,3796,268507
Malaysia,2020-08,31,284714,3880,280834
Malaysia,2020-09,30,303981,3904,300077
Malaysia,2020-10,31,641436,5804,635632
Malaysia,2020-11,6,216926,1620,215306
Maldives,2020-01,10,0,0,0
Maldives,2020-02,29,0,0,0
Maldives,2020-03,31,307,0,307
Maldives,2020-04,30,2969,3,2966
Maldives,2020-05,31,33979,112,33867
Maldives,2020-06,30,63073,239,62834
Maldives,2020-07,31,91652,429,91223
Maldives,2020-08,31,186738,722,186016
Maldives,2020-09,30,281343,965,280378
Maldives,2020-10,31,345017,1109,343908
Maldives,2020-11,6,71154,230,70924
Mali,2020-03,12,134,7,127
Mali,2020-04,30,6360,406,5954
Mali,2020-05,31,27261,1595,25666
Mali,2020-06,30,54821,3080,51741
Mali,2020-07,31,75551,3761,71790
Mali,2020-08,31,82016,3877,78139
Mali,2020-09,30,89013,3851,85162
Mali,2020-10,31,104443,4109,100334
Mali,2020-11,6,21724,820,20904
Malta,2020-01,10,0,0,0
Malta,2020-02,29,0,0,0
Malta,2020-03,31,1876,0,1876
Malta,2020-04,30,11395,75,11320
Malta,2020-05,31,17073,186,16887
Malta,2020-06,30,19529,270,19259
Malta,2020-07,31,21500,279,21221
Malta,2020-08,31,42973,297,42676
Malta,2020-09,30,75818,613,75205
Malta,2020-10,31,140537,1453,139084
Malta,2020-11,6,40186,413,39773
Marshall Islands,2020-03,12,0,0,0
Marshall Islands,2020-04,30,0,0,0
Marshall Islands,2020-05,31,0,0,0
Marshall Islands,2020-06,30,0,0,0
Marshall Islands,2020-07,31,0,0,0
Marshall Islands,2020-08,31,0,0,0
Marshall Islands,2020-09,30,0,0,0
Marshall Islands,2020-10,31,10,0,10
Marshall Islands,2020-11,6,9,0,9
Martinique,2020-01,10,0,0,0
Martinique,2020-02,29,0,0,0
Martinique,2020-03,19,131,5,126
Mauritania,2020-01,10,0,0,0
Mauritania,2020-02,29,0,0,0
Mauritania,2020-03,31,52,3,49
Mauritania,2020-04,30,206,30,176
Mauritania,2020-05,31,4579,204,4375
Mauritania,2020-06,30,70883,2678,68205
Mauritania,2020-07,31,174812,4588,170224
Mauritania,2020-08,31,208955,4884,204071
Mauritania,2020-09,30,219563,4823,214740
Mauritania,2020-10,31,235803,5046,230757
Mauritania,2020-11,6,46558,986,45572
Mauritius,2020-01,10,0,0,0
Mauritius,2020-02,29,0,0,0
Mauritius,2020-03,31,984,31,953
Mauritius,2020-04,30,9103,260,8843
Mauritius,2020-05,31,10314,310,10004
Mauritius,2020-06,30,10142,300,9842
Mauritius,2020-07,31,10625,310,10315
Mauritius,2020-08,31,10762,310,10452
Mauritius,2020-09,30,10921,300,10621
Mauritius,2020-10,31,12862,310,12552
Mauritius,2020-11,6,2718,60,2658
Mexico,2020-01,31,0,0,0
Mexico,2020-02,29,9,0,9
Mexico,2020-03,31,9183,165,9018
Mexico,2020-04,30,247523,21220,226303
Mexico,2020-05,31,1631783,173556,1458227
Mexico,2020-06,30,4827865,580521,4247344
Mexico,2020-11,6,5679073,560481,5118592
Moldova,2020-01,10,0,0,0
Moldova,2020-02,29,0,0,0
Moldova,2020-03,31,2681,25,2656
Moldova,2020-04,30,66261,1703,64558
Moldova,2020-05,31,188196,6528,181668
Moldova,2020-06,30,379077,12847,366230
Moldova,2020-07,31,642019,20932,621087
Moldova,2020-08,31,960514,27963,932551
Moldova,2020-09,30,1352584,35172,1317412
Moldova,2020-10,31,2047121,48471,1998650
Moldova,2020-11,6,473881,11152,462729
Monaco,2020-01,31,0,0,0
Monaco,2020-02,29,2,0,2
Monaco,2020-03,31,484,4,480
Monaco,2020-04,30,2649,73,2576
Monaco,2020-05,31,2997,124,2873
Monaco,2020-06,30,3004,120,2884
Monaco,2020-07,31,3454,124,3330
Monaco,2020-08,31,4442,124,4318
Monaco,2020-09,30,5453,37,5416
Monaco,2020-10,31,8404,62,8342
Monaco,2020-11,6,2529,12,2517
Mongolia,2020-01,10,0,0,0
Mongolia,2020-02,29,0,0,0
Mongolia,2020-03,31,162,0,162
Mongolia,2020-04,30,810,0,810
Mongolia,2020-05,31,3250,0,3250
Mongolia,2020-06,30,6114,0,6114
Mongolia,2020-07,31,8118,0,8118
Mongolia,2020-08,31,9217,0,9217
Mongolia,2020-09,30,9344,0,9344
Mongolia,2020-10,31,10104,0,10104
Mongolia,2020-11,6,2128,0,2128
Montenegro,2020-01,10,0,0,0
Montenegro,2020-02,29,0,0,0
Montenegro,2020-03,31,810,12,798
Montenegro,2020-04,30,8401,127,8274
Montenegro,2020-05,31,10039,271,9768
Montenegro,2020-06,30,11145,280,10865
Montenegro,2020-07,31,57153,924,56229
Montenegro,2020-08,31,126012,2374,123638
Montenegro,2020-09,30,233126,3960,229166
Montenegro,2020-10,31,469067,7215,461852
Montenegro,2020-11,6,126102,1964,124138
Morocco,2020-01,10,0,0,0
Morocco,2020-02,29,0,0,0
Morocco,2020-03,31,4375,228,4147
Morocco,2020-04,30,75673,3747,71926
Morocco,2020-05,31,206722,5953,200769
Morocco,2020-06,30,289137,6411,282726
Morocco,2020-07,31,542342,8544,533798
Morocco,2020-08,31,1360900,22496,1338404
Morocco,2020-09,30,2828343,51335,2777008
Morocco,2020-10,31,5328517,90661,5237856
Morocco,2020-11,6,1427054,24088,1402966
Mozambique,2020-03,12,64,0,64
Mozambique,2020-04,30,1130,0,1130
Mozambique,2020-05,31,4559,13,4546
Mozambique,2020-06,30,18522,108,18414
Mozambique,2020-07,31,42735,295,42440
Mozambique,2020-08,31,90614,581,90033
Mozambique,2020-09,30,184762,1213,183549
Mozambique,2020-10,31,336936,2387,334549
Mozambique,2020-11,6,80095,580,79515
Namibia,2020-01,10,0,0,0
Namibia,2020-02,29,0,0,0
Namibia,2020-03,31,108,0,108
Namibia,2020-04,30,477,0,477
Namibia,2020-05,31,562,0,562
Namibia,2020-06,30,2024,0,2024
Namibia,2020-07,31,35878,119,35759
Namibia,2020-08,31,142901,1183,141718
Namibia,2020-09,30,297202,3169,294033
Namibia,2020-10,31,379340,4027,375313
Namibia,2020-11,6,78517,798,77719
Nepal,2020-01,31,8,0,8
Nepal,2020-02,29,29,0,29
Nepal,2020-03,31,60,0,60
Nepal,2020-04,30,844,0,844
Nepal,2020-05,31,15021,66,14955
Nepal,2020-06,30,222344,590,221754
Nepal,2020-07,31,541742,1266,540476
Nepal,2020-08,31,883252,3825,879427
Nepal,2020-09,30,1785629,11408,1774221
Nepal,2020-10,31,3989303,22553,3966750
Nepal,2020-11,6,1105601,6237,1099364
Netherlands,2020-01,31,0,0,0
Netherlands,2020-02,29,14,0,14
Netherlands,2020-03,31,114671,6877,107794
Netherlands,2020-04,30,874401,98631,775770
Netherlands,2020-05,31,1364283,174396,1189887
Netherlands,2020-06,30,1471746,182416,1289330
Netherlands,2020-07,31,1614372,190841,1423531
Netherlands,2020-08,31,2005149,192347,1812802
Netherlands,2020-09,30,2855928,189903,2666025
Netherlands,2020-10,31,7256516,212848,7043668
Netherlands,2020-11,6,2361830,46698,2315132
New Zealand,2020-01,31,0,0,0
New Zealand,2020-02,29,3,0,3
New Zealand,2020-03,31,4283,4,4279
New Zealand,2020-04,30,39691,290,39401
New Zealand,2020-05,31,46454,655,45799
New Zealand,2020-06,30,45341,660,44681
New Zealand,2020-07,31,48010,682,47328
New Zealand,2020-08,31,50882,682,50200
New Zealand,2020-09,30,54209,733,53476
New Zealand,2020-10,31,58879,775,58104
New Zealand,2020-11,6,11842,150,11692
Nicaragua,2020-01,10,0,0,0
Nicaragua,2020-02,29,0,0,0
Nicaragua,2020-03,31,38,6,32
Nicaragua,2020-04,30,278,53,225
Nicaragua,2020-05,31,7547,468,7079
Nicaragua,2020-06,30,51063,1839,49224
Nicaragua,2020-07,31,96979,3081,93898
Nicaragua,2020-08,31,129592,4016,125576
Nicaragua,2020-09,30,147656,4383,143273
Nicaragua,2020-10,31,166121,4772,161349
Nicaragua,2020-11,6,33315,939,32376
Niger,2020-03,12,145,14,131
Niger,2020-04,30,15775,540,15235
Niger,2020-05,31,27224,1628,25596
Niger,2020-06,30,30377,1985,28392
Niger,2020-07,31,34367,2126,32241
Niger,2020-08,31,36111,2139,33972
Niger,2020-09,30,35551,2070,33481
Niger,2020-10,31,37474,2139,35335
Niger,2020-11,6,7356,414,6942
Nigeria,2020-01,31,0,0,0
Nigeria,2020-02,29,3,0,3
Nigeria,2020-03,31,977,13,964
Nigeria,2020-04,30,21303,630,20673
Nigeria,2020-05,31,189096,5704,183392
Nigeria,2020-06,30,536727,13627,523100
Nigeria,2020-07,31,1098937,23819,1075118
Nigeria,2020-08,31,1534665,30151,1504514
Nigeria,2020-09,30,1702028,32565,1669463
Nigeria,2020-10,31,1893830,34832,1858998
Nigeria,2020-11,6,380618,6920,373698
North Macedonia,2020-01,31,0,0,0
North Macedonia,2020-02,29,5,0,5
North Macedonia,2020-03,31,2797,49,2748
North Macedonia,2020-04,30,30222,1351,28871
North Macedonia,2020-05,31,56226,3220,53006
North Macedonia,2020-06,30,131960,6345,125615
North Macedonia,2020-07,31,272216,12669,259547
North Macedonia,2020-08,31,397161,17024,380137
North Macedonia,2020-09,30,488123,20174,467949
North Macedonia,2020-10,31,734823,26319,708504
North Macedonia,2020-11,6,214236,6431,207805
Norway,2020-01,31,0,0,0
Norway,2020-02,29,38,0,38
Norway,2020-03,31,56074,273,55801
Norway,2020-04,30,203405,4429,198976
Norway,2020-05,31,254671,7074,247597
Norway,2020-06,30,260432,7304,253128
Norway,2020-07,31,280211,7859,272352
Norway,2020-08,31,311311,8072,303239
Norway,2020-09,30,376954,8011,368943
Norway,2020-10,31,518974,8609,510365
Norway,2020-11,6,137076,1700,135376
Oman,2020-01,31,0,0,0
Oman,2020-02,29,28,0,28
Oman,2020-03,31,1886,2,1884
Oman,2020-04,30,34358,174,34184
Oman,2020-05,31,178283,812,177471
Oman,2020-06,30,781218,3449,777769
Oman,2020-07,31,1957950,9444,1948506
Oman,2020-08,31,2571208,17748,2553460
Oman,2020-09,30,2753856,24407,2729449
Oman,2020-10,31,3361947,33782,3328165
Oman,2020-11,6,702328,7691,694637
Pakistan,2020-01,31,0,0,0
Pakistan,2020-02,29,14,0,14
Pakistan,2020-03,31,19308,178,19130
Pakistan,2020-04,30,262401,5283,257118
Pakistan,2020-05,31,1370682,29303,1341379
Pakistan,2020-06,30,4591349,91705,4499644
Pakistan,2020-07,31,7975264,167840,7807424
Pakistan,2020-08,31,8951916,191144,8760772
Pakistan,2020-09,30,9135691,192143,8943548
Pakistan,2020-10,31,10027128,206295,9820833
Pakistan,2020-11,6,2037588,41430,1996158
Panama,2020-01,10,0,0,0
Panama,2020-02,29,0,0,0
Panama,2020-03,31,8498,166,8332
Panama,2020-04,30,118038,3245,114793
Panama,2020-05,31,303691,8414,295277
Panama,2020-06,30,691389,14298,677091
Panama,2020-07,31,1576705,32595,1544110
Panama,2020-08,31,2523134,55050,2468084
Panama,2020-09,30,3114917,66305,3048612
Panama,2020-10,31,3844493,79182,3765311
Panama,2020-11,6,819356,16497,802859
Papua New Guinea,2020-03,12,12,0,12
Papua New Guinea,2020-04,30,146,0,146
Papua New Guinea,2020-05,31,248,0,248
Papua New Guinea,2020-06,30,264,0,264
Papua New Guinea,2020-07,31,847,9,838
Papua New Guinea,2020-08,31,9568,107,9461
Papua New Guinea,2020-09,30,15379,181,15198
Papua New Guinea,2020-10,31,17668,217,17451
Papua New Guinea,2020-11,6,3575,42,3533
Paraguay,2020-01,10,0,0,0
Paraguay,2020-02,29,0,0,0
Paraguay,2020-03,31,611,29,582
Paraguay,2020-04,30,5247,211,5036
Paraguay,2020-05,31,23039,330,22709
Paraguay,2020-06,30,42696,378,42318
Paraguay,2020-07,31,110203,951,109252
Paraguay,2020-08,31,334478,4959,329519
Paraguay,2020-09,30,918464,18121,900343
Paraguay,2020-10,31,1666341,36299,1630042
Paraguay,2020-11,6,393328,8744,384584
Peru,2020-01,10,0,0,0
Peru,2020-02,29,0,0,0
Peru,2020-03,31,8767,172,8595
Peru,2020-04,30,446855,12077,434778
Peru,2020-05,31,2980056,85001,2895055
Peru,2020-06,30,7055583,215555,6840028
Peru,2020-07,31,10784010,433594,10350416
Peru,2020-08,31,16644881,768750,15876131
Peru,2020-11,6,5463282,207878,5255404
Philippines,2020-01,31,3,0,3
Philippines,2020-02,29,82,29,53
Philippines,2020-03,31,13534,756,12778
Philippines,2020-04,30,170088,10571,159517
Philippines,2020-05,31,396036,24763,371273
Philippines,2020-06,30,832839,33360,799479
Philippines,2020-07,31,2005270,51351,1953919
Philippines,2020-08,31,5108025,84106,5023919
Philippines,2020-09,30,8161536,138862,8022674
Philippines,2020-10,31,10917498,202675,10714823
Philippines,2020-11,6,2336425,44302,2292123
Poland,2020-01,10,0,0,0
Poland,2020-02,29,0,0,0
Poland,2020-03,31,18535,246,18289
Poland,2020-04,30,245796,9932,235864
Poland,2020-05,31,579613,27879,551734
Poland,2020-06,30,901431,38637,862794
Poland,2020-07,31,1234877,49841,1185036
Poland,2020-08,31,1779958,58603,1721355
Poland,2020-09,30,2338495,67923,2270572
Poland,2020-10,31,5888571,114841,5773730
Poland,2020-11,6,2721240,40020,2681220
Portugal,2020-01,10,0,0,0
Portugal,2020-02,29,0,0,0
Portugal,2020-03,31,54362,952,53410
Portugal,2020-04,30,550644,18851,531793
Portugal,2020-05,31,898967,37988,860979
Portugal,2020-06,30,1130109,45522,1084587
Portugal,2020-07,31,1475316,51934,1423382
Portugal,2020-08,31,1688351,55168,1633183
Portugal,2020-09,30,1997077,56757,1940320
Portugal,2020-10,31,3166124,68072,3098052
Portugal,2020-11,6,951442,16280,935162
Qatar,2020-01,31,0,0,0
Qatar,2020-02,29,2,0,2
Qatar,2020-03,31,11072,7,11065
Qatar,2020-04,30,169463,223,169240
Qatar,2020-05,31,1048194,604,1047590
Qatar,2020-06,30,2433099,2441,2430658
Qatar,2020-07,31,3267660,4703,3262957
Qatar,2020-08,31,3572299,5875,3566424
Qatar,2020-09,30,3677652,6243,3671409
Qatar,2020-10,31,4010223,6930,4003293
Qatar,2020-11,6,800835,1392,799443
Romania,2020-01,31,0,0,0
Romania,2020-02,29,11,0,11
Romania,2020-03,31,16976,396,16580
Romania,2020-04,30,232958,12265,220693
Romania,2020-05,31,514672,33175,481497
Romania,2020-06,30,687725,43658,644067
Romania,2020-07,31,1157441,62035,1095406
Romania,2020-08,31,2206836,93918,2112918
Romania,2020-09,30,3252080,129012,3123068
Romania,2020-10,31,5578407,181700,5396707
Romania,2020-11,6,1632479,44810,1587669
Russia,2020-01,31,4,0,4
Russia,2020-02,29,58,0,58
Russia,2020-03,31,14559,71,14488
Russia,2020-04,30,1233598,11179,1222419
Russia,2020-05,31,8556438,85933,8470505
Russia,2020-06,30,16338665,219881,16118784
Russia,2020-07,31,23424573,371110,23053463
Russia,2020-08,31,28661985,487325,28174660
Russia,2020-09,30,32467537,569176,31898361
Russia,2020-10,31,42985023,745261,42239762
Russia,2020-11,6,10142542,174703,9967839
Rwanda,2020-01,10,0,0,0
Rwanda,2020-02,29,0,0,0
Rwanda,2020-03,31,654,0,654
Rwanda,2020-04,30,4433,0,4433
Rwanda,2020-05,31,9467,3,9464
Rwanda,2020-06,30,19581,60,19521
Rwanda,2020-07,31,47034,131,46903
Rwanda,2020-08,31,85807,309,85498
Rwanda,2020-09,30,138445,715,137730
Rwanda,2020-10,31,154390,1008,153382
Rwanda,2020-11,6,31108,213,30895
Saint Kitts and Nevis,2020-03,12,33,0,33
Saint Kitts and Nevis,2020-04,30,392,0,392
Saint Kitts and Nevis,2020-05,31,465,0,465
Saint Kitts and Nevis,2020-06,30,450,0,450
Saint Kitts and Nevis,2020-07,31,517,0,517
Saint Kitts and Nevis,2020-08,31,527,0,527
Saint Kitts and Nevis,2020-09,30,532,0,532
Saint Kitts and Nevis,2020-10,31,589,0,589
Saint Kitts and Nevis,2020-11,6,114,0,114
Saint Lucia,2020-01,10,0,0,0
Saint Lucia,2020-02,29,0,0,0
Saint Lucia,2020-03,31,79,0,79
Saint Lucia,2020-04,30,446,0,446
Saint Lucia,2020-05,31,557,0,557
Saint Lucia,2020-06,30,568,0,568
Saint Lucia,2020-07,31,709,0,709
Saint Lucia,2020-08,31,790,0,790
Saint Lucia,2020-09,30,803,0,803
Saint Lucia,2020-10,31,1305,0,1305
Saint Lucia,2020-11,6,618,0,618
Saint Vincent and the Grenadines,2020-01,10,0,0,0
Saint Vincent and the Grenadines,2020-02,29,0,0,0
Saint Vincent and the Grenadines,2020-03,31,19,0,19
Saint Vincent and the Grenadines,2020-04,30,344,0,344
Saint Vincent and the Grenadines,2020-05,31,577,0,577
Saint Vincent and the Grenadines,2020-06,30,837,0,837
Saint Vincent and the Grenadines,2020-07,31,1258,0,1258
Saint Vincent and the Grenadines,2020-08,31,1785,0,1785
Saint Vincent and the Grenadines,2020-09,30,1898,0,1898
Saint Vincent and the Grenadines,2020-10,31,2102,0,2102
Saint Vincent and the Grenadines,2020-11,6,454,0,454
San Marino,2020-01,31,0,0,0
San Marino,2020-02,29,4,0,4
San Marino,2020-03,31,3696,344,3352
San Marino,2020-04,30,12387,1109,11278
San Marino,2020-05,31,19945,1281,18664
San Marino,2020-06,30,20750,1260,19490
San Marino,2020-07,31,21662,1302,20360
San Marino,2020-08,31,21800,1302,20498
San Marino,2020-09,30,21734,1260,20474
San Marino,2020-10,31,24448,1302,23146
San Marino,2020-11,6,6045,252,5793
Sao Tome and Principe,2020-03,12,0,0,0
Sao Tome and Principe,2020-04,30,132,0,132
Sao Tome and Principe,2020-05,31,8093,225,7868
Sao Tome and Principe,2020-06,30,19096,368,18728
Sao Tome and Principe,2020-07,31,23910,431,23479
Sao Tome and Principe,2020-08,31,27461,465,26996
Sao Tome and Principe,2020-09,30,27161,450,26711
Sao Tome and Principe,2020-10,31,28843,469,28374
Sao Tome and Principe,2020-11,6,5743,96,5647
Saudi Arabia,2020-01,10,0,0,0
Saudi Arabia,2020-02,29,0,0,0
Saudi Arabia,2020-03,31,13829,49,13780
Saudi Arabia,2020-04,30,283286,2639,280647
Saudi Arabia,2020-05,31,1722768,9973,1712795
Saudi Arabia,2020-06,30,4169152,32668,4136484
Saudi Arabia,2020-07,31,7543376,74000,7469376
Saudi Arabia,2020-08,31,9272726,106533,9166193
Saudi Arabia,2020-09,30,9818242,131390,9686852
Saudi Arabia,2020-10,31,10593081,159539,10433542
Saudi Arabia,2020-11,6,2094887,32883,2062004
Senegal,2020-01,10,0,0,0
Senegal,2020-02,29,0,0,0
Senegal,2020-03,31,1619,0,1619
Senegal,2020-04,30,12783,127,12656
Senegal,2020-05,31,74966,806,74160
Senegal,2020-06,30,160517,2185,158332
Senegal,2020-07,31,267908,5071,262837
Senegal,2020-08,31,375819,7817,368002
Senegal,2020-09,30,434070,8966,425104
Senegal,2020-10,31,476708,9844,466864
Senegal,2020-11,6,93961,1956,92005
Serbia,2020-01,10,0,0,0
Serbia,2020-02,29,0,0,0
Serbia,2020-03,31,6765,87,6678
Serbia,2020-04,30,158104,3222,154882
Serbia,2020-05,31,327351,6973,320378
Serbia,2020-06,30,380372,7731,372641
Serbia,2020-07,31,629459,13683,615776
Serbia,2020-08,31,912326,20754,891572
Serbia,2020-09,30,978814,22078,956736
Serbia,2020-10,31,1160100,24113,1135987
Serbia,2020-11,6,326824,5136,321688
Seychelles,2020-01,10,0,0,0
Seychelles,2020-02,29,0,0,0
Seychelles,2020-03,31,121,0,121
Seychelles,2020-04,30,326,0,326
Seychelles,2020-05,31,341,0,341
Seychelles,2020-06,30,604,0,604
Seychelles,2020-07,31,3155,0,3155
Seychelles,2020-08,31,3994,0,3994
Seychelles,2020-09,30,4203,0,4203
Seychelles,2020-10,31,4640,0,4640
Seychelles,2020-11,6,940,0,940
Sierra Leone,2020-03,12,2,0,2
Sierra Leone,2020-04,30,1231,35,1196
Sierra Leone,2020-05,31,15534,908,14626
Sierra Leone,2020-06,30,36000,1579,34421
Sierra Leone,2020-07,31,52132,1998,50134
Sierra Leone,2020-08,31,60465,2132,58333
Sierra Leone,2020-09,30,63970,2155,61815
Sierra Leone,2020-10,31,71936,2261,69675
Sierra Leone,2020-11,6,14220,444,13776
Singapore,2020-01,31,66,0,66
Singapore,2020-02,29,1884,0,1884
Singapore,2020-03,31,12100,28,12072
Singapore,2020-04,30,204192,294,203898
Singapore,2020-05,31,843580,663,842917
Singapore,2020-06,30,1219262,766,1218496
Singapore,2020-07,31,1480335,825,1479510
Singapore,2020-08,31,1724118,837,1723281
Singapore,2020-09,30,1722596,810,1721786
Singapore,2020-10,31,1795188,858,1794330
Singapore,2020-11,6,348226,168,348058
Slovakia,2020-01,10,0,0,0
Slovakia,2020-02,29,0,0,0
Slovakia,2020-03,31,3803,4,3799
Slovakia,2020-04,30,29296,283,29013
Slovakia,2020-05,31,45878,837,45041
Slovakia,2020-06,30,47279,840,46439
Slovakia,2020-07,31,61471,870,60601
Slovakia,2020-08,31,94062,979,93083
Slovakia,2020-09,30,193489,1187,192302
Slovakia,2020-10,31,939199,3294,935905
Slovakia,2020-11,6,405349,1635,403714
Slovenia,2020-01,10,0,0,0
Slovenia,2020-02,29,0,0,0
Slovenia,2020-03,31,9411,98,9313
Slovenia,2020-04,30,37232,1822,35410
Slovenia,2020-05,31,45316,3208,42108
Slovenia,2020-06,30,45501,3279,42222
Slovenia,2020-07,31,59339,3508,55831
Slovenia,2020-08,31,76920,3999,72921
Slovenia,2020-09,30,124200,4189,120011
Slovenia,2020-10,31,482747,6402,476345
Slovenia,2020-11,6,240748,2731,238017
Solomon Islands,2020-03,12,0,0,0
Solomon Islands,2020-04,30,0,0,0
Solomon Islands,2020-05,31,0,0,0
Solomon Islands,2020-06,30,0,0,0
Solomon Islands,2020-07,31,0,0,0
Solomon Islands,2020-08,31,0,0,0
Solomon Islands,2020-09,30,0,0,0
Solomon Islands,2020-10,31,95,0,95
Solomon Islands,2020-11,6,78,0,78
Somalia,2020-01,10,0,0,0
Somalia,2020-02,29,0,0,0
Somalia,2020-03,31,34,0,34
Somalia,2020-04,30,5910,274,5636
Somalia,2020-05,31,42149,1729,40420
Somalia,2020-06,30,78479,2599,75880
Somalia,2020-07,31,96134,2869,93265
Somalia,2020-08,31,100915,2910,98005
Somalia,2020-09,30,102907,2939,99968
Somalia,2020-10,31,119309,3122,116187
Somalia,2020-11,6,25086,639,24447
South Africa,2020-01,10,0,0,0
South Africa,2020-02,29,0,0,0
South Africa,2020-03,31,11526,17,11509
South Africa,2020-04,30,92338,1461,90877
South Africa,2020-05,31,524410,10359,514051
South Africa,2020-06,30,2539997,50152,2489845
South Africa,2020-07,31,10399891,158566,10241325
South Africa,2020-08,31,18086446,365913,17720533
South Africa,2020-09,30,19635331,470960,19164371
South Africa,2020-10,31,21762064,565983,21196081
South Africa,2020-11,6,4389114,117899,4271215
South Sudan,2020-03,12,0,0,0
South Sudan,2020-04,30,226,0,226
South Sudan,2020-05,31,13009,126,12883
South Sudan,2020-06,30,50181,808,49373
South Sudan,2020-07,31,66995,1302,65693
South Sudan,2020-08,31,77057,1455,75602
South Sudan,2020-09,30,78365,1461,76904
South Sudan,2020-10,31,87430,1689,85741
South Sudan,2020-11,6,17659,355,17304
Spain,2020-01,31,0,0,0
Spain,2020-02,29,196,0,196
Spain,2020-03,31,839293,63074,776219
Spain,2020-04,30,5354289,564239,4790050
Spain,2020-11,6,7748451,227022,7521429
Sri Lanka,2020-01,31,6,0,6
Sri Lanka,2020-02,29,29,0,29
Sri Lanka,2020-03,31,1613,8,1605
Sri Lanka,2020-04,30,9587,198,9389
Sri Lanka,2020-05,31,32956,282,32674
Sri Lanka,2020-06,30,57515,331,57184
Sri Lanka,2020-07,31,79223,341,78882
Sri Lanka,2020-08,31,90327,352,89975
Sri Lanka,2020-09,30,97528,378,97150
Sri Lanka,2020-10,31,191741,451,191290
Sri Lanka,2020-11,6,74173,158,74015
Sudan,2020-01,10,0,0,0
Sudan,2020-02,29,0,0,0
Sudan,2020-03,31,60,23,37
Sudan,2020-04,30,3444,311,3133
Sudan,2020-05,31,79546,3779,75767
Sudan,2020-06,30,229477,14029,215448
Sudan,2020-07,31,331641,20940,310701
Sudan,2020-08,31,385376,24722,360654
Sudan,2020-09,30,405013,25017,379996
Sudan,2020-10,31,425019,25925,399094
Sudan,2020-11,6,83558,5022,78536
Suriname,2020-01,10,0,0,0
Suriname,2020-02,29,0,0,0
Suriname,2020-03,31,97,0,97
Suriname,2020-04,30,301,29,272
Suriname,2020-05,31,355,31,324
Suriname,2020-06,30,7869,179,7690
Suriname,2020-07,31,31649,610,31039
Suriname,2020-08,31,94472,1475,92997
Suriname,2020-09,30,138408,2818,135590
Suriname,2020-10,31,157892,3359,154533
Suriname,2020-11,6,31336,670,30666
Sweden,2020-01,31,2,0,2
Sweden,2020-02,29,64,0,64
Sweden,2020-03,31,51001,2499,48502
Sweden,2020-04,30,408107,54703,353404
Sweden,2020-05,31,955795,124225,831570
Sweden,2020-06,30,1640337,155785,1484552
Sweden,2020-07,31,2289523,176288,2113235
Sweden,2020-08,31,2526474,179912,2346562
Sweden,2020-09,30,2640835,175761,2465074
Sweden,2020-10,31,3272245,183565,3088680
Sweden,2020-11,6,831303,36022,795281
Switzerland,2020-01,31,0,0,0
Switzerland,2020-02,29,54,0,54
Switzerland,2020-03,31,171688,2999,168689
Switzerland,2020-04,30,780839,37373,743466
Switzerland,2020-05,31,945264,57936,887328
Switzerland,2020-06,30,936461,58344,878117
Switzerland,2020-07,31,1037195,61105,976090
Switzerland,2020-08,31,1195102,61815,1133287
Switzerland,2020-09,30,1449968,61168,1388800
Switzerland,2020-10,31,2728221,65696,2662525
Switzerland,2020-11,6,1177186,15507,1161679
Syria,2020-03,12,62,7,55
Syria,2020-04,30,954,73,881
Syria,2020-05,31,2162,106,2056
Syria,2020-06,30,5703,206,5497
Syria,2020-07,31,15728,788,14940
Syria,2020-08,31,55015,2262,52753
Syria,2020-09,30,109251,4891,104360
Syria,2020-10,31,155719,7574,148145
Syria,2020-11,6,36000,1821,34179
Taiwan*,2020-01,31,63,0,63
Taiwan*,2020-02,29,645,15,630
Taiwan*,2020-03,31,4160,53,4107
Taiwan*,2020-04,30,11995,172,11823
Taiwan*,2020-05,31,13638,208,13430
Taiwan*,2020-06,30,13346,210,13136
Taiwan*,2020-07,31,14082,217,13865
Taiwan*,2020-08,31,14975,217,14758
Taiwan*,2020-09,30,15064,210,14854
Taiwan*,2020-10,31,16634,217,16417
Taiwan*,2020-11,6,3416,42,3374
Tajikistan,2020-03,12,0,0,0
Tajikistan,2020-04,30,30,0,30
Tajikistan,2020-05,31,55454,962,54492
Tajikistan,2020-06,30,154266,1506,152760
Tajikistan,2020-07,31,210056,1747,208309
Tajikistan,2020-08,31,250442,2001,248441
Tajikistan,2020-09,30,276302,2176,274126
Tajikistan,2020-10,31,324141,2475,321666
Tajikistan,2020-11,6,67183,497,66686
Tanzania,2020-01,10,0,0,0
Tanzania,2020-02,29,0,0,0
Tanzania,2020-03,31,182,2,180
Tanzania,2020-04,30,5036,186,4850
Tanzania,2020-05,31,15605,621,14984
Tanzania,2020-06,30,15270,630,14640
Tanzania,2020-07,31,15779,651,15128
Tanzania,2020-08,31,15779,651,15128
Tanzania,2020-09,30,15270,630,14640
Tanzania,2020-10,31,15779,651,15128
Tanzania,2020-11,6,3054,126,2928
Thailand,2020-01,31,127,0,127
Thailand,2020-02,29,955,0,955
Thailand,2020-03,31,15089,82,15007
Thailand,2020-04,30,78454,1226,77228
Thailand,2020-05,31,93828,1733,92095
Thailand,2020-06,30,94082,1740,92342
Thailand,2020-07,31,100525,1798,98727
Thailand,2020-08,31,104600,1798,102802
Thailand,2020-09,30,104753,1753,103000
Thailand,2020-10,31,114261,1829,112432
Thailand,2020-11,6,22892,357,22535
Timor-Leste,2020-03,12,11,0,11
Timor-Leste,2020-04,30,388,0,388
Timor-Leste,2020-05,31,744,0,744
Timor-Leste,2020-06,30,720,0,720
Timor-Leste,2020-07,31,744,0,744
Timor-Leste,2020-08,31,790,0,790
Timor-Leste,2020-09,30,813,0,813
Timor-Leste,2020-10,31,896,0,896
Timor-Leste,2020-11,6,180,0,180
Togo,2020-01,10,0,0,0
Togo,2020-02,29,0,0,0
Togo,2020-03,31,312,6,306
Togo,2020-04,30,2395,141,2254
Togo,2020-05,31,8760,350,8410
Togo,2020-06,30,16410,398,16012
Togo,2020-07,31,24095,492,23603
Togo,2020-08,31,36550,785,35765
Togo,2020-09,30,48462,1185,47277
Togo,2020-10,31,63840,1586,62254
Togo,2020-11,6,14539,342,14197
Trinidad and Tobago,2020-01,10,0,0,0
Trinidad and Tobago,2020-02,29,0,0,0
Trinidad and Tobago,2020-03,31,844,19,825
Trinidad and Tobago,2020-04,30,3344,234,3110
Trinidad and Tobago,2020-05,31,3599,248,3351
Trinidad and Tobago,2020-06,30,3642,240,3402
Trinidad and Tobago,2020-07,31,4349,248,4101
Trinidad and Tobago,2020-08,31,23598,377,23221
Trinidad and Tobago,2020-09,30,101010,1660,99350
Trinidad and Tobago,2020-10,31,162481,2959,159522
Trinidad and Tobago,2020-11,6,34604,663,33941
Tunisia,2020-01,10,0,0,0
Tunisia,2020-02,29,0,0,0
Tunisia,2020-03,31,2870,74,2796
Tunisia,2020-04,30,23656,971,22685
Tunisia,2020-05,31,32295,1421,30874
Tunisia,2020-06,30,33774,1484,32290
Tunisia,2020-07,31,41535,1550,39985
Tunisia,2020-08,31,74563,1883,72680
Tunisia,2020-09,30,288112,4343,283769
Tunisia,2020-10,31,1214858,20829,1194029
Tunisia,2020-11,6,389699,9138,380561
Turkey,2020-01,10,0,0,0
Turkey,2020-02,29,0,0,0
Turkey,2020-03,31,72307,1190,71117
Turkey,2020-04,30,2204880,52552,2152328
Turkey,2020-05,31,4565447,125729,4439718
Turkey,2020-06,30,5465534,146041,5319493
Turkey,2020-07,31,6743720,168904,6574816
Turkey,2020-08,31,7784142,186425,7597717
Turkey,2020-09,30,8913526,219399,8694127
Turkey,2020-10,31,10764065,287228,10476837
Turkey,2020-11,6,2313840,63598,2250242
US,2020-01,31,46,0,46
US,2020-02,29,683,2,681
US,2020-03,31,1309609,30396,1279213
Uganda,2020-03,12,255,0,255
Uganda,2020-04,30,1836,0,1836
Uganda,2020-05,31,6271,0,6271
Uganda,2020-06,30,21622,0,21622
Uganda,2020-07,31,32434,18,32416
Uganda,2020-08,31,56768,496,56272
Uganda,2020-09,30,166903,1722,165181
Uganda,2020-10,31,325184,2955,322229
Uganda,2020-11,6,80941,726,80215
Ukraine,2020-01,10,0,0,0
Ukraine,2020-02,29,0,0,0
Ukraine,2020-03,31,3709,106,3603
Ukraine,2020-04,30,147182,3867,143315
Ukraine,2020-05,31,556858,15628,541230
Ukraine,2020-06,30,1032880,28440,1004440
Ukraine,2020-07,31,1823672,45661,1778011
Ukraine,2020-08,31,3005715,66750,2938965
Ukraine,2020-09,30,5109848,103518,5006330
Ukraine,2020-10,31,9477156,178125,9299031
Ukraine,2020-11,6,2630745,48265,2582480
United Arab Emirates,2020-01,31,16,0,16
United Arab Emirates,2020-02,29,285,0,285
United Arab Emirates,2020-03,31,6158,38,6120
United Arab Emirates,2020-04,30,187641,1269,186372
United Arab Emirates,2020-05,31,740762,6590,734172
United Arab Emirates,2020-06,30,1288803,8818,1279985
United Arab Emirates,2020-07,31,1735875,10417,1725458
United Arab Emirates,2020-08,31,2018931,11344,2007587
United Arab Emirates,2020-09,30,2474556,12042,2462514
United Arab Emirates,2020-10,31,3550222,14243,3535979
United Arab Emirates,2020-11,6,828259,3034,825225
United Kingdom,2020-01,31,4,0,4
United Kingdom,2020-02,29,263,0,263
United Kingdom,2020-03,31,301556,14897,286659
United Kingdom,2020-04,30,3468300,481513,2986787
United Kingdom,2020-11,6,6685737,287617,6398120
Uruguay,2020-01,10,0,0,0
Uruguay,2020-02,29,0,0,0
Uruguay,2020-03,31,3265,5,3260
Uruguay,2020-04,30,15449,296,15153
Uruguay,2020-05,31,22898,611,22287
Uruguay,2020-06,30,26075,731,25344
Uruguay,2020-07,31,33185,988,32197
Uruguay,2020-08,31,44946,1233,43713
Uruguay,2020-09,30,55501,1375,54126
Uruguay,2020-10,31,79000,1607,77393
Uruguay,2020-11,6,19680,366,19314
Uzbekistan,2020-01,10,0,0,0
Uzbekistan,2020-02,29,0,0,0
Uzbekistan,2020-03,31,1234,11,1223
Uzbekistan,2020-04,30,36920,151,36769
Uzbekistan,2020-05,31,87180,369,86811
Uzbekistan,2020-06,30,173486,575,172911
Uzbekistan,2020-07,31,494761,2505,492256
Uzbekistan,2020-08,31,1086017,7388,1078629
Uzbekistan,2020-09,30,1483733,12177,1471556
Uzbekistan,2020-10,31,1945927,16211,1929716
Uzbekistan,2020-11,6,407097,3463,403634
Venezuela,2020-01,10,0,0,0
Venezuela,2020-02,29,0,0,0
Venezuela,2020-03,31,1431,14,1417
Venezuela,2020-04,30,7043,279,6764
Venezuela,2020-05,31,23568,323,23245
Venezuela,2020-06,30,106208,917,105291
Venezuela,2020-07,31,362717,3361,359356
Venezuela,2020-08,31,1051898,8836,1043062
Venezuela,2020-09,30,1899018,15492,1883526
Venezuela,2020-10,31,2655107,22557,2632550
Venezuela,2020-11,6,562128,4894,557234
Vietnam,2020-01,31,20,0,20
Vietnam,2020-02,29,412,0,412
Vietnam,2020-03,31,2710,0,2710
Vietnam,2020-04,30,7836,0,7836
Vietnam,2020-05,31,9523,0,9523
Vietnam,2020-06,30,10223,0,10223
Vietnam,2020-07,31,12481,6,12475
Vietnam,2020-08,31,28577,668,27909
Vietnam,2020-09,30,31947,1049,30898
Vietnam,2020-10,31,35134,1085,34049
Vietnam,2020-11,6,7228,210,7018
West Bank and Gaza,2020-03,12,1013,7,1006
West Bank and Gaza,2020-04,30,8822,52,8770
West Bank and Gaza,2020-05,31,12344,72,12272
West Bank and Gaza,2020-06,30,27918,104,27814
West Bank and Gaza,2020-07,31,240347,1539,238808
West Bank and Gaza,2020-08,31,530473,3594,526879
West Bank and Gaza,2020-09,30,982538,7131,975407
West Bank and Gaza,2020-10,31,1458746,12622,1446124
West Bank and Gaza,2020-11,6,337937,3034,334903
Western Sahara,2020-03,12,0,0,0
Western Sahara,2020-04,30,148,0,148
Western Sahara,2020-05,31,213,7,206
Western Sahara,2020-06,30,280,30,250
Western Sahara,2020-07,31,310,31,279
Western Sahara,2020-08,31,310,31,279
Western Sahara,2020-09,30,300,30,270
Western Sahara,2020-10,31,310,31,279
Western Sahara,2020-11,6,60,6,54
Yemen,2020-03,12,0,0,0
Yemen,2020-04,30,37,4,33
Yemen,2020-05,31,4432,868,3564
Yemen,2020-06,30,24099,6164,17935
Yemen,2020-07,31,47208,13113,34095
Yemen,2020-08,31,57841,16590,41251
Yemen,2020-09,30,60403,17457,42946
Yemen,2020-10,31,63683,18474,45209
Yemen,2020-11,6,12386,3609,8777
Zambia,2020-01,10,0,0,0
Zambia,2020-02,29,0,0,0
Zambia,2020-03,31,229,0,229
Zambia,2020-04,30,1825,65,1760
Zambia,2020-05,31,19573,192,19381
Zambia,2020-06,30,40575,389,40186
Zambia,2020-07,31,94951,2736,92215
Zambia,2020-08,31,297104,7754,289350
Zambia,2020-09,30,413524,9522,404002
Zambia,2020-10,31,488182,10633,477549
Zambia,2020-11,6,100358,2094,98264
Zimbabwe,2020-03,12,60,10,50
Zimbabwe,2020-04,30,650,89,561
Zimbabwe,2020-05,31,2009,124,1885
Zimbabwe,2020-06,30,12509,145,12364
Zimbabwe,2020-07,31,50691,781,49910
Zimbabwe,2020-08,31,166621,4271,162350
Zimbabwe,2020-09,30,224912,6643,218269
Zimbabwe,2020-10,31,251872,7245,244627
Zimbabwe,2020-11,6,50619,1487,49132
